
   ***************************
   *                         *  
   *                         *
   *                         *
   *                         *
   ***************************
   *                         *
   *                         *
   *                         *
   ***************************